1111111111111
10010000000C1
10C0011111C01
1P0011E000C01
1111111111111