11111111
1C0000C1
1E000001
11111001
1C0000P1
11111111