1111111111111
10010000000C1
10C0011111111
1P0011E001C01
1111111111111