1111111111111
1P000000000C1
1000111110011
100111E000001
1111111111111